..oo.....oo.....oo..
..bb.....bb.....bb..
.....oo......oo.....
o....bb......bb....o
o.......oooo.......o
o....oo.bbbb.oo....o
o....bb......bb....o
o.oo.....oo.....oo.o
o.bb.....bb.....bb.o
.....oo......oo.....
.....bb......bb.....
........oooo........
........bbbb........
.....oo......oo.....
..oo.bb..oo..bb.oo..
..bb............bb..
poooooooo..ooooooooo
bb..bb..b..bb..bb.b